// bulldozer storage "level2" last updated 16-11-2015 00:39:35
nextlevel=level2
"a20" 4 "0 0 0" ; 
"b20" 4 "0 0 0" ; 
"c20" 4 "0 0 0" ; 
"d20" 4 "0 0 0" ; 
"e20" 4 "0 0 0" ; 
"f20" 4 "0 0 0" ; 
"g20" 4 "0 0 0" ; 
"h20" 4 "0 0 0" ; 
"i20" 4 "0 0 0" ; 
"j20" 4 "0 0 0" ; 
"k20" 4 "0 0 0" ; 
"l20" 4 "0 0 0" ; 
"m20" 4 "0 0 0" ; 
"n20" 4 "0 0 0" ; 
"o20" 4 "0 0 0" ; 
"p20" 4 "0 0 0" ; 
"q20" 4 "0 0 0" ; 
"r20" 4 "0 0 0" ; 
"s20" 4 "0 0 0" ; 
"t20" 4 "0 0 0" ; 
"t19" 4 "0 0 0" ; 
"t18" 4 "0 0 0" ; 
"t17" 4 "0 0 0" ; 
"t16" 4 "0 0 0" ; 
"t15" 4 "0 0 0" ; 
"t14" 4 "0 0 0" ; 
"t13" 4 "0 0 0" ; 
"t9" 4 "0 0 0" ; 
"s9" 4 "0 0 0" ; 
"r9" 4 "0 0 0" ; 
"q9" 4 "0 0 0" ; 
"p9" 4 "0 0 0" ; 
"o9" 4 "0 0 0" ; 
"n9" 4 "0 0 0" ; 
"m9" 4 "0 0 0" ; 
"l9" 4 "0 0 0" ; 
"k9" 4 "0 0 0" ; 
"j9" 4 "0 0 0" ; 
"i9" 4 "0 0 0" ; 
"h9" 4 "0 0 0" ; 
"g9" 4 "0 0 0" ; 
"f9" 4 "0 0 0" ; 
"e9" 4 "0 0 0" ; 
"d9" 4 "0 0 0" ; 
"c9" 4 "0 0 0" ; 
"b9" 4 "0 0 0" ; 
"a9" 4 "0 0 0" ; 
"a10" 4 "0 0 0" ; 
"a11" 4 "0 0 0" ; 
"a12" 4 "0 0 0" ; 
"a13" 4 "0 0 0" ; 
"a14" 4 "0 0 0" ; 
"a15" 4 "0 0 0" ; 
"a16" 4 "0 0 0" ; 
"a17" 4 "0 0 0" ; 
"a18" 4 "0 0 0" ; 
"a19" 4 "0 0 0" ; 
"t12" 4 "0 0 0" ; 
"t11" 4 "0 0 0" ; 
"t10" 4 "0 0 0" ; 
"k4" 4 "0 0 0" ; 
"t3" 4 "0 0 0" ; 
"s4" 4 "0 0 0" ; 
"t2" 4 "0 0 0" ; 
"l5" 4 "0 0 0" ; 
"j6" 4 "0 0 0" ; 
"c19" 4 "0 0 0" ; 
"r6" 4 "0 0 0" ; 
"c18" 4 "0 0 0" ; 
"c17" 4 "0 0 0" ; 
"i6" 4 "0 0 0" ; 
"c7" 4 "0 0 0" ; 
"c16" 4 "0 0 0" ; 
"c15" 4 "0 0 0" ; 
"c14" 4 "0 0 0" ; 
"c13" 4 "0 0 0" ; 
"o6" 4 "0 0 0" ; 
"p6" 4 "0 0 0" ; 
"c12" 4 "0 0 0" ; 
"l7" 4 "0 0 0" ; 
"l6" 4 "0 0 0" ; 
"t6" 4 "0 0 0" ; 
"t5" 4 "0 0 0" ; 
"b19" 2 "0 0 0" ; 
"k5" 4 "0 0 0" ; 
"b18" 2 "0 0 0" ; 
"p5" 4 "0 0 0" ; 
"j4" 4 "0 0 0" ; 
"k15" 1 "0 0 0" ; 
"g16" 3 "0 0 0" ; 
"g12" 3 "0 0 0" ; 
"l3" 4 "0 0 0" ; 
"b6" 4 "0 0 0" ; 
"i5" 4 "0 0 0" ; 
"b5" 4 "0 0 0" ; 
"r10" 4 "0 0 0" ; 
"b4" 4 "0 0 0" ; 
"r12" 4 "0 0 0" ; 
"r11" 4 "0 0 0" ; 
"r13" 4 "0 0 0" ; 
"c3" 4 "0 0 0" ; 
"r14" 4 "0 0 0" ; 
"r15" 4 "0 0 0" ; 
"d6" 4 "0 0 0" ; 
"r17" 4 "0 0 0" ; 
"r18" 4 "0 0 0" ; 
"s10" 2 "0 0 0" ; 
"d5" 4 "0 0 0" ; 
"s11" 2 "0 0 0" ; 
"d4" 4 "0 0 0" ; 
"o17" 3 "0 0 0" ; 
"o13" 3 "0 0 0" ; 
"l4" 4 "0 0 0" ; 
"h7" 4 "0 0 0" ; 
"o4" 4 "0 0 0" ; 
"p4" 4 "0 0 0" ; 
"t4" 4 "0 0 0" ; 
"h6" 4 "0 0 0" ; 
"h5" 4 "0 0 0" ; 
"h4" 4 "0 0 0" ; 
"h3" 4 "0 0 0" ; 
"f4" 4 "0 0 0" ; 
"f5" 4 "0 0 0" ; 
"f6" 4 "0 0 0" ; 
"n6" 4 "0 0 0" ; 
"d3" 4 "0 0 0" ; 
"o5" 4 "0 0 0" ; 
"n4" 4 "0 0 0" ; 
"a2" 4 "0 0 0" ; 
"b2" 4 "0 0 0" ; 
"c2" 4 "0 0 0" ; 
"d2" 4 "0 0 0" ; 
"e2" 4 "0 0 0" ; 
"f2" 4 "0 0 0" ; 
"g2" 4 "0 0 0" ; 
"h2" 4 "0 0 0" ; 
"i2" 4 "0 0 0" ; 
"j2" 4 "0 0 0" ; 
"k2" 4 "0 0 0" ; 
"l2" 4 "0 0 0" ; 
"m2" 4 "0 0 0" ; 
"n2" 4 "0 0 0" ; 
"o2" 4 "0 0 0" ; 
"p2" 4 "0 0 0" ; 
"q2" 4 "0 0 0" ; 
"r2" 4 "0 0 0" ; 
"s2" 4 "0 0 0" ; 
"t1" 4 "0 0 0" ; 
"s1" 4 "0 0 0" ; 
"r1" 4 "0 0 0" ; 
"q1" 4 "0 0 0" ; 
"p1" 4 "0 0 0" ; 
"o1" 4 "0 0 0" ; 
"n1" 4 "0 0 0" ; 
"m1" 4 "0 0 0" ; 
"l1" 4 "0 0 0" ; 
"k1" 4 "0 0 0" ; 
"j1" 4 "0 0 0" ; 
"i1" 4 "0 0 0" ; 
"h1" 4 "0 0 0" ; 
"g1" 4 "0 0 0" ; 
"f1" 4 "0 0 0" ; 
"e1" 4 "0 0 0" ; 
"d1" 4 "0 0 0" ; 
"c1" 4 "0 0 0" ; 
"b1" 4 "0 0 0" ; 
"a1" 4 "0 0 0" ; 
"t7" 4 "0 0 0" ; 
"p3" 4 "0 0 0" ; 
"p7" 4 "0 0 0" ; 
"d7" 4 "0 0 0" ; 
"r3" 4 "0 0 0" ; 
"c8" 4 "0 0 0" ; 
"b8" 4 "0 0 0" ; 
"a8" 4 "0 0 0" ; 
"d8" 4 "0 0 0" ; 
"e8" 4 "0 0 0" ; 
"f8" 4 "0 0 0" ; 
"g8" 4 "0 0 0" ; 
"h8" 4 "0 0 0" ; 
"i8" 4 "0 0 0" ; 
"j8" 4 "0 0 0" ; 
"k8" 4 "0 0 0" ; 
"l8" 4 "0 0 0" ; 
"m8" 4 "0 0 0" ; 
"n8" 4 "0 0 0" ; 
"o8" 4 "0 0 0" ; 
"p8" 4 "0 0 0" ; 
"q8" 4 "0 0 0" ; 
"r8" 4 "0 0 0" ; 
"s8" 4 "0 0 0" ; 
"t8" 4 "0 0 0" ; 
